1111111
1000001
1000001
1000001
1300001
1111101
1100001
1150001
1111111
